15 15
*** ***********
*     *       *
*  *  * ***** *
**** ** ***   *
*     *  *  ***
* *** **   *  *
* * * ** *** **
*   * ** **   *
***** *     * *
*   * *** **  *
* *       ** **
* **********  *
* *********** *
*        *    *
********** ****