30 30
* ****************************
*           *                *
*********** * * *** **** *****
*           * * *   *        *
* * ********* * ***** ****** *
*** *         *     *      * *
*   * ************* ****** * *
* *** *       *     *      * *
* * * * *** *** ***** ****** *
*     * *   *      *  *    * *
* ***** * *** **** * *  ** * *
* *   * * * * *    *   *   * *
* *** * * * * *********** ** *
*     * * * *     *        * *
* ***** * * ***** * * ****** *
*       * * *   * * * *      *
* ******* * * * * * * * **** *
* *     *   * * * * * * *    *
* * ******* * * * * * * * ****
* *         * * * * * * *    *
* ********* * * * * * * **** *
*     *     * * * * * * *    *
******* ***** * * ***** ******
*       *     * *    *       *
* ******* ***** **** *********
* *           *   *          *
*   ********* * * ********** *
* * *   *   * * * *   *   * **
* * * *   *   * *   *   *    *
**************************** *
